0 0 0 0 0 0 0 0 0 0 0 0 0 0 0 0 0 0 0 0 0 0 0 0 0 0 0 0 0 0 0 0 0 0 0 0 0 0 0 0 
0 0 0 0 0 0 0 0 0 0 0 0 0 0 0 0 0 0 0 0 0 0 0 0 0 0 0 0 0 0 0 0 0 0 0 0 0 0 0 0 
0 0 0 0 0 0 0 0 0 0 0 0 0 0 0 0 0 0 0 0 0 0 0 0 0 0 0 0 0 0 78 79 80 81 0 0 0 0 0 0 
0 0 0 0 0 0 0 0 0 0 0 0 0 0 0 0 0 0 0 0 0 0 0 0 0 0 0 0 0 0 82 83 84 85 0 0 0 0 0 0 
0 0 0 0 0 0 0 0 0 0 0 0 0 0 0 0 0 0 0 0 0 0 0 0 0 0 96 0 0 0 86 87 88 89 0 0 0 0 0 0 
0 0 0 0 0 0 0 0 0 0 0 0 0 0 0 61 61 61 61 0 0 0 0 0 0 0 0 0 0 0 90 91 92 93 0 0 0 0 0 0 
0 0 0 0 0 0 0 0 0 0 0 0 0 0 0 30 30 30 30 27 0 0 0 0 0 0 0 0 49 49 4 1 1 2 0 0 0 0 0 0 
0 0 0 0 0 0 0 0 0 0 0 0 0 0 4 1 1 1 1 2 0 0 0 0 0 0 0 0 0 49 8 9 9 10 0 0 0 0 49 49 
0 0 0 0 62 63 64 65 0 0 0 0 0 61 8 9 9 9 9 10 0 0 0 0 0 0 0 0 0 49 8 9 9 10 0 0 0 0 0 0 
0 0 0 0 66 67 68 69 0 0 0 0 0 61 11 9 12 12 9 10 30 30 30 30 0 0 0 0 0 49 8 12 12 10 40 40 40 0 0 0 
0 0 47 48 70 71 72 73 0 0 0 0 0 61 8 9 12 12 9 10 0 0 0 0 0 0 0 49 36 31 8 9 12 10 6 6 6 7 0 0 
0 0 51 52 74 75 76 17 18 18 18 19 28 90 11 9 12 12 9 10 49 0 0 0 0 49 53 4 1 1 8 9 9 10 9 9 9 10 0 0 
0 0 4 1 1 1 2 23 21 24 21 25 4 1 1 1 2 9 9 10 49 0 0 0 0 49 0 8 9 12 8 12 9 10 9 12 12 13 0 0 
0 0 11 9 12 9 13 0 0 0 0 0 11 12 9 12 13 9 9 10 49 0 0 0 0 49 0 11 9 12 8 9 9 13 9 12 12 13 0 0 
0 0 14 15 15 15 16 0 0 0 0 0 14 15 15 15 16 15 15 10 49 0 0 0 0 49 0 14 15 15 14 15 15 16 15 15 15 16 0 0

0 0 0 0 0 0 0 0 0 0 0 0 0 0 0 0 0 0 0 0 0 0 0 0 0 0 0 0 0 0 0 0 0 0 0 0 0 0 0 23 
1 1 0 0 0 0 1 1 1 1 1 0 0 0 0 0 0 0 0 0 0 0 0 0 0 0 0 0 0 0 0 0 0 0 0 0 0 0 0 23 
0 0 0 0 0 0 0 0 0 0 0 0 0 0 0 0 0 0 0 0 0 0 7 10 10 10 10 10 10 10 7 0 0 0 0 0 0 0 0 23 
1 1 1 0 0 0 0 0 0 0 0 0 0 0 0 0 0 0 0 0 0 0 0 0 0 0 0 0 0 0 0 0 0 0 0 0 0 0 0 23 
0 0 0 0 0 0 0 0 0 0 0 0 0 0 0 2 10 10 10 2 0 0 0 0 0 0 0 0 0 0 0 0 0 0 0 0 0 0 0 23 
0 0 0 0 0 0 0 0 0 0 0 98 0 0 0 0 0 0 0 0 0 0 0 0 0 0 0 0 8 8 8 0 8 8 8 0 0 7 7 23 
2 2 0 0 0 0 0 0 0 0 1 1 1 0 0 0 0 0 0 0 0 0 0 0 0 0 0 0 8 8 8 88 8 8 8 0 0 0 0 23 
2 2 2 2 0 0 0 0 0 0 2 2 2 0 0 0 0 0 0 0 0 0 49 0 0 0 0 0 0 8 8 8 8 8 0 0 0 0 0 23 
2 2 2 2 2 2 0 0 0 0 0 0 0 0 0 0 0 0 0 0 0 0 81 0 104 0 0 0 0 0 0 0 0 0 0 0 0 0 24 23 
2 2 2 2 2 2 2 0 0 0 0 0 0 0 0 0 0 0 0 0 3 3 3 3 3 3 0 0 0 0 0 0 0 0 0 0 0 24 24 23 
0 0 0 0 0 0 0 0 0 0 0 0 0 0 0 0 0 0 0 0 0 0 0 0 0 0 0 0 0 0 0 0 0 0 0 0 24 24 24 23 
0 0 0 0 0 0 0 0 0 0 0 0 1 1 0 0 0 0 0 0 0 0 0 0 0 0 0 0 0 0 0 0 0 0 0 24 24 24 24 23 
1 1 1 1 1 1 1 1 1 0 0 0 0 0 0 0 0 1 1 1 1 1 1 1 1 1 1 1 1 1 1 26 26 26 24 24 24 24 24 24 
2 2 2 2 2 2 2 2 2 149 149 149 149 149 149 149 149 2 2 2 2 2 2 2 2 2 2 2 2 2 2 181 181 181 9 9 9 9 9 23 
2 2 2 2 2 2 2 2 2 165 165 165 165 165 165 165 165 2 2 2 2 2 2 2 2 2 2 2 2 2 2 197 197 197 9 9 9 9 9 23

3 0 0 0 0 0 0 0 0 0 0 0 0 0 0 0 0 0 0 0 0 0 0 0 0 0 0 0 0 0 0 0 0 0 0 0 0 0 0 0 
3 0 0 0 0 0 0 0 0 0 0 0 0 0 61 0 0 0 0 0 0 0 0 0 0 0 0 0 0 0 12 0 0 0 0 0 0 0 0 0 
3 0 0 0 0 0 0 0 58 0 0 0 0 0 0 0 0 0 0 0 0 0 0 0 0 0 0 0 0 0 36 0 0 0 0 0 8 0 0 0 
3 0 0 0 0 0 0 0 38 26 26 0 0 0 0 0 0 0 0 0 0 0 0 0 0 0 0 0 12 0 36 0 0 0 0 0 0 0 0 0 
3 0 0 52 0 0 0 38 30 30 0 0 0 0 0 0 0 57 0 0 0 0 0 0 0 0 0 0 36 0 36 0 33 19 0 0 0 0 12 0 
3 0 0 0 0 0 38 30 30 30 0 0 0 0 30 30 30 30 30 0 0 0 26 26 0 0 12 0 36 0 36 0 0 0 0 0 0 0 30 0 
3 0 0 0 0 38 30 30 30 30 0 0 0 0 0 0 0 0 0 0 0 0 0 0 0 0 36 0 36 0 36 0 0 0 0 0 0 0 30 0 
30 26 26 26 26 45 30 30 30 30 26 26 26 0 26 26 26 26 26 30 30 38 26 26 26 26 36 26 36 26 36 26 26 26 26 26 26 26 30 26 
30 30 30 30 30 30 30 30 30 30 30 30 30 30 30 30 30 30 30 30 26 30 30 30 30 30 30 30 30 30 30 30 30 30 30 30 30 30 30 30 
30 30 30 30 30 30 30 30 30 30 30 30 30 30 30 30 30 30 30 30 26 30 30 30 30 30 30 30 30 30 30 30 30 30 30 30 30 30 30 30 
30 30 30 30 30 30 30 30 30 30 30 30 30 30 30 30 30 30 30 30 26 30 30 30 30 30 30 30 30 30 30 30 30 30 30 30 30 30 30 30 
30 30 30 30 30 30 30 30 30 30 30 30 30 30 30 30 30 30 30 30 26 30 30 30 30 30 30 30 30 30 30 30 30 30 30 30 30 30 30 30 
30 30 30 30 30 30 30 30 30 30 30 30 30 30 30 30 30 30 30 30 26 30 30 30 30 30 30 30 30 30 30 30 30 30 30 30 30 30 30 30 




