0 0 0 0 0 0 0 0 0 0 0 0 0 0 0 0 0 0 0 0 0 0 0 0 0 0 0 0 0 0 0 0 0 0 0 0 0 0 0 0 0 0 0 0 0 0 0 0 0 0 0 0 0 0 0 0 0 0 0 0 0 0 0 0 0 0 0 0 0 0 0 0 0 0 0 0 0 0 0 0 
0 0 0 0 0 0 0 0 0 0 0 0 0 0 0 0 0 0 0 0 0 0 0 0 0 0 0 0 0 0 0 0 0 0 0 0 0 0 0 0 0 0 0 0 0 0 0 0 0 0 0 0 0 0 0 0 0 0 0 0 0 0 0 0 0 0 0 0 0 0 0 0 0 111 0 0 0 0 0 0 
0 0 0 0 0 0 0 0 0 0 0 0 0 0 0 0 0 0 0 0 0 0 0 0 0 0 0 0 0 0 0 0 0 0 0 0 0 0 0 0 0 0 0 0 0 0 0 0 0 0 0 0 0 0 0 0 0 0 0 0 0 0 0 0 0 0 0 0 0 0 0 0 0 131 0 0 0 0 0 0 
23 23 23 23 23 4 0 0 0 0 0 0 0 0 0 0 0 0 0 0 0 0 0 0 0 0 0 0 0 0 0 0 0 0 0 0 0 0 0 0 0 0 0 0 0 0 0 0 0 0 0 0 0 0 0 0 0 0 0 0 0 147 0 0 0 0 0 0 0 0 0 0 2 23 23 23 23 23 23 23 
123 123 123 123 144 0 0 0 0 0 0 0 0 0 0 0 0 0 0 0 0 0 0 0 0 0 0 21 0 0 128 0 0 0 0 0 0 0 0 0 0 0 0 0 0 0 0 0 0 0 0 0 0 0 0 0 0 0 0 0 0 0 0 0 0 0 0 0 0 0 0 0 0 142 123 123 123 123 123 123 
123 123 123 144 0 0 0 0 0 147 0 0 0 0 0 0 0 0 0 0 0 0 0 0 0 0 0 122 23 23 24 0 0 0 86 0 0 0 0 0 0 0 0 0 0 0 0 0 0 0 0 0 0 0 0 0 0 0 147 0 0 0 0 0 0 0 0 0 0 0 0 0 0 0 142 123 123 123 123 123 
123 123 144 0 0 0 0 0 0 0 0 0 0 0 0 0 0 0 0 0 0 0 0 0 21 0 0 122 123 123 123 23 23 23 24 0 0 0 0 0 0 0 0 0 0 0 0 0 0 0 0 0 0 0 0 0 0 0 0 0 0 0 0 0 0 0 0 0 0 0 148 0 0 0 0 142 123 123 123 123 
123 144 0 0 0 0 0 0 0 0 0 0 147 0 0 0 0 0 0 0 0 0 0 0 121 0 0 122 123 123 123 123 123 123 144 0 0 0 0 0 0 0 0 0 0 0 0 0 0 0 0 0 0 0 0 147 0 0 0 0 0 0 0 0 0 0 0 0 0 0 0 0 0 0 0 0 142 123 123 123 
144 0 0 185 184 184 0 0 0 0 0 0 0 0 0 0 0 0 0 0 0 0 0 0 121 0 0 122 123 123 123 123 123 144 0 0 0 0 0 0 0 0 0 0 0 0 0 0 0 0 0 0 0 0 0 0 0 0 0 0 0 0 0 0 0 0 0 148 0 0 0 0 0 0 0 0 0 142 143 143 
0 0 0 183 183 183 0 0 0 0 0 0 0 0 0 0 0 0 0 0 0 21 0 0 121 0 0 122 123 123 123 123 144 0 0 0 0 0 0 0 0 0 0 0 0 0 0 0 0 0 0 0 147 0 0 0 0 0 0 0 0 0 0 0 0 0 0 0 0 0 0 0 0 0 0 0 0 0 0 0 
0 0 0 0 0 0 0 0 0 0 0 0 0 0 0 0 0 0 0 0 0 121 0 0 121 0 0 122 123 123 123 144 0 0 0 0 0 0 0 0 0 0 0 0 0 0 0 0 0 0 0 0 0 0 0 0 0 0 0 0 0 0 0 0 0 0 0 0 0 0 0 0 0 0 0 0 0 0 0 0 
0 0 189 0 0 0 0 0 0 0 0 0 0 0 0 0 0 0 0 0 0 121 0 0 121 0 0 122 123 123 144 0 0 0 0 0 147 0 0 0 0 0 0 0 0 126 0 0 0 0 0 0 0 0 0 0 0 0 0 0 0 0 0 0 0 0 0 0 0 0 0 0 0 0 0 0 0 0 127 0 
3 23 23 35 23 23 23 24 0 0 0 0 0 0 0 0 0 0 21 0 0 121 0 0 121 0 0 122 123 124 0 0 0 0 0 0 0 0 0 0 0 0 22 23 23 23 23 35 24 0 0 0 0 0 0 0 0 0 15 14 14 14 13 14 14 14 16 0 0 0 0 0 0 0 0 0 0 0 22 23 
0 142 123 55 123 123 123 124 0 0 0 0 0 0 0 0 0 0 121 0 0 121 0 0 121 0 0 122 123 123 24 0 0 0 0 0 0 0 0 0 0 0 122 123 123 123 123 55 124 0 0 0 0 0 0 0 0 0 0 0 0 0 33 0 0 0 0 0 0 0 0 0 0 0 0 0 0 22 123 123 
0 0 142 55 123 123 123 124 0 0 0 0 0 0 0 0 0 0 121 0 0 121 54 54 121 0 0 122 123 123 123 24 0 0 0 0 0 0 0 0 0 0 122 123 123 123 123 55 124 0 0 0 0 0 0 0 0 0 0 0 0 0 53 0 0 0 0 0 0 0 0 0 0 0 0 0 0 122 123 123 
0 0 0 55 123 123 123 124 0 0 0 0 0 0 0 21 0 0 121 0 0 121 74 74 121 0 0 122 123 123 123 123 24 0 0 0 0 0 0 22 23 23 23 35 24 123 123 55 124 0 0 0 0 0 0 0 0 0 0 0 0 0 33 0 0 0 0 0 0 0 0 0 0 0 0 0 22 123 123 123 
0 0 0 55 142 123 123 124 0 0 0 0 0 0 0 121 0 0 121 54 54 121 74 74 121 0 0 122 123 123 123 123 123 24 0 0 0 0 0 122 123 123 123 55 124 123 123 55 124 0 0 15 14 14 13 14 14 16 0 0 0 0 53 0 0 0 0 0 0 0 0 0 0 0 22 23 123 123 123 123 
0 0 0 55 0 142 123 124 0 0 0 0 21 0 0 121 0 0 121 74 74 121 74 74 121 0 0 122 123 123 123 123 123 123 24 0 0 0 0 122 123 123 123 55 124 123 123 55 124 0 0 0 0 0 33 0 0 0 0 0 0 0 73 0 0 0 0 0 0 0 0 0 0 22 123 123 123 123 123 123 
54 54 54 55 54 54 142 124 0 0 0 0 121 0 0 121 54 54 121 74 74 121 74 74 121 133 135 122 123 123 123 123 123 123 124 34 34 34 34 122 123 123 123 55 124 123 123 55 124 0 0 0 0 0 73 0 0 22 23 23 23 23 23 23 23 23 23 24 0 0 0 0 0 122 123 123 123 123 123 123 
74 74 74 75 74 74 74 121 121 121 21 121 121 54 54 121 74 74 121 74 74 121 74 74 121 0 0 122 123 123 123 123 123 123 124 74 74 74 74 122 123 123 123 75 124 123 123 75 124 0 0 22 23 23 23 23 23 24 123 123 123 123 123 123 123 123 123 124 0 0 0 0 22 123 123 123 123 123 123 123


